                                        
 ##########                             
    #               ###############     
    ########           #          #     
    #      #    ########          #     
    #      #                      #     
    ##########################    #     
    #       #         #           #     
    #  $    #         ##########  #     
    #  #    #         #           #     
    #  #    ###########    ########     
       #    #              #            
       #    #           ####            
       #    #           ############    
       #    ###############        #    
       #                           #    
       #############################    
                                        
                                        
                                        
                                        
                                        
                                        
