                                        
 z################                      
 #   #        #  #                      
 #   #        #  ##################     
 #   #        #            #      #     
 #   #        #            #      #     
 #   #######  #   ##########      #     
 #         #  #            #      #     
 ####################      #      #     
 #           #                    #     
 #           #                    #     
 #           #       #            #     
 #           #       #            #     
 #           #       #            #     
             #       #            #     
  ################   ###############    
                #            #######    
                #                       
                ##########$             
                                        
